0000001001110
0000011101010
0000111111010
0001111111110
0111111111110
1111111111111
0100000000010
0101110000010
0101010011110
0101110010010
0100000010110
0100000010010
0100000010010
0111111111110