0000100000
0001110000
0010110000
0100111000
0100111000
0110111100
0011111100
0000100000
1111111111
0111111110
