1111111111
1001111001
0000110000
0000000000
0000000000
1000000001
1100000011
1110000111
1111001111
1111111111