000000000011000
000000000111100
000000000111100
000000000011100
000000000001110
000000000011110
000000000111110
000000001111110
000000000111010
000011000110010
000111101110010
001111111110010
011111111110011
011001111110001
110000111100000
