0011111111
1111111111
1011111111
0111111110
0000111100
